R 1500 1000




NO ./north_texture.xpm
SO ./south_texture.xpm
WE ./west_texture.xpm
EA ./east_texture.xpm
S ./coin.xpm
F 80,50,50
C 30,50,70




        1111111111111111111111111
        1000000000110000000000001111111111111111111111111111111
        1011000001110000002000000000000000000000000000000000001
        1001000000000000000000001111111111111111111111111111111
111111111011000001110000000000001
100000000011000001110111110111111
11110111111111011100000010001
11110111111111011101010010001
11000000110101011100000010001
10002000000000001100000010001
10000000000000001101010010001
11000001110101011111011110W001
11110111 1110101 101111010001
11111111 1111111 1111111111111
